111111
1C0001
111001
1PC0E1
111111
