1111111111111111
1000000000000001
1000000000000001
1E00000000000001
10000000000P0001
10C0000000000001
1111111111111111
