1111111111111111111111111111111111
1E1000000000000C000001000000000001
1000010100100000101001000000010101
1000010010101010001001000000010101
1P1000001C10C1000000000000000001C1
1111111111111111111111111111111111