11111111111111
1CCCCCCCCCCCC1
1CPC0000010001
1C0C0C000010E1
11111111111111
