111111111111111
1P00000000000C1
100011111110001
1C000C000C00001
1000000000000E1
111111111111111
