1111111111111
1000C01111111
1P000000010E1
1111111111111
