1111111111111
1000001110001
1011111010001
1000011011111
1111111000001
1000C01111111
1P000000000E1
1111111111111
